1,4,3,5,1,7,2,1,6,2,1,3,1,3,2,4,1,7,5,6,5,4,3,1
1,0,0,0,0,0,0,0,0,0,0,0,0,0,0,0,0,0,0,0,0,0,0,6
4,0,1,2,3,0,0,0,0,0,0,0,0,3,0,0,0,0,0,0,0,3,0,3
1,0,2,2,2,0,0,0,0,0,0,0,0,0,5,0,0,0,0,0,7,0,0,5
4,0,3,2,1,0,1,2,3,4,1,0,0,0,0,3,0,2,0,1,0,0,0,3
2,0,0,0,0,0,5,0,0,0,2,0,0,0,0,0,0,0,0,0,0,0,0,1
1,3,0,1,0,0,2,0,0,0,3,0,0,0,0,2,0,0,0,4,0,0,0,7
2,0,0,0,0,0,3,0,0,0,2,0,0,0,0,0,0,0,0,0,0,0,0,2
1,3,0,2,0,0,2,4,0,2,4,0,0,0,0,2,0,4,0,3,0,0,0,1
2,0,0,0,0,0,0,0,0,0,0,0,4,4,0,0,0,0,0,0,3,0,0,2
1,3,0,5,0,0,0,3,0,0,0,0,3,1,0,0,0,0,0,0,0,3,0,1
6,0,0,0,0,3,0,0,0,0,4,3,4,4,1,7,0,0,0,0,0,0,0,6
3,3,0,6,0,0,0,5,0,0,7,2,4,4,2,3,0,0,0,0,0,0,0,1
1,0,0,0,0,3,0,0,0,0,0,0,4,2,0,0,0,0,0,0,0,0,0,5
7,3,0,3,0,0,0,6,0,0,0,0,3,4,0,0,0,0,0,0,0,0,0,2
2,0,0,0,0,0,0,0,0,0,0,0,0,0,1,0,0,0,0,0,3,4,0,1
1,4,4,2,4,3,4,1,4,3,4,2,6,0,5,0,0,0,4,0,5,0,0,4
2,4,0,6,0,0,0,0,5,0,0,0,5,0,6,0,3,3,5,0,3,6,0,2
3,4,0,0,0,0,2,0,3,0,6,0,4,0,1,0,4,0,0,0,0,2,0,4
1,4,0,3,0,0,0,0,1,0,4,0,3,0,1,0,3,1,1,3,0,3,0,6
7,7,0,5,6,7,2,3,4,0,7,0,2,0,4,0,3,0,0,0,0,2,0,4
3,5,0,0,0,0,0,0,0,0,4,0,4,4,4,0,3,0,1,2,2,3,0,1
1,6,4,1,4,2,4,3,4,0,5,0,0,0,0,0,0,0,0,0,0,0,0,2
3,1,1,1,1,1,1,1,1,1,1,6,1,5,7,3,1,3,6,5,4,3,2,1
